##############################################
#                                 $          #
# #####################  #############    ## #
#                                    #       #
#      @                                     #
# ########  #############################  ###
# #                                          #
#                      #                     #
##########  ########## ###############  #### #
#                                            #
##############################################